
F 255,100,251


NO ./image/textureN.xpm
EA ./image/textureE.xpm
SO ./image/textureS.xpm
WE ./image/textureW.xpm

C 72,74,153
       11111111111111111111111111111  111111111111
        1000000000110000000000001101  110011
        101100000111000000000000111   10001
        100100000000000000000000111   111111
111111111011000001110000000000001
1100000000011000001110111111111111
1111011111111101110000010001
11110111111111011101010010001
110000001101010111000000100011                                    111111
1000000000 00000001100000010001                                     11101
100E00000000000011010100100011                                     11101
11000001110101011111011110000111                                    111
11110111 1110101 101111010001
11111111 1111111 111111111111
1111111
1010001
111111

