NO    ./path_to_the_north_texture 44          



# algo flood fill


SO./path_to_the_suth_texture           
WE ./path_to_the_west_texture





EA ./path_to_the_east_texture

F 220,100,0
C 225,30,0


            1111111111111111111111111111111111
1111111111111000000000000011110001000000000000000000001
100000000000000000001    00000000000000000000001
11111111111111111111111111111111111111111111111
1
1
1111111111111111111111111111111111111

1
11
1
1
11111111111111111111111111111111



