EA ./image/collect.xpm
C 72,74,153  

NO  ./image/floor.xpm
F 4,104,04


SO./image/exit.xpm
WE ./image/wall.xpm

       11111111111111111111111111111  111111111111                                                                              
        1000000000110000000000001101  110011
        101100000111000000000000111   10001
        100100000000000000000000111   111111
111111111011000001110000000000001
1100000000011000001110111111111111
1111011111111101110000010001
11110111111111011101010010001                                             1
11000000110101011110000001000111                                    1111111
100000000000001 10001100000010001                                     11101
100E00000000001110011010100100011                                     11101
11000001110101011111011110000111                                    111  1
11110111 1110101 101111010001
11111111 1111111 111111111111
1111111
1010001
111111

