
C 50,50,100

F 100,50,50


NO ./image/textureN.xpm
EA ./image/textureE.xpm
SO ./image/textureS.xpm
WE ./image/textureW.xpm

111111111
11E000001
1111111111
111111
